14,0,0,0,0,0,0,0,0,0,0,0,0,0,0,0,0,0,0,12
14,0,0,0,0,0,0,0,0,0,0,0,0,0,0,0,0,0,0,12
14,0,0,0,0,0,0,0,0,0,0,0,0,0,0,0,0,0,0,12
14,0,0,0,0,0,0,0,0,0,0,0,0,0,0,0,0,0,0,12
14,0,0,0,0,0,0,0,0,0,0,0,0,0,0,0,0,0,0,12
14,0,0,0,0,0,0,0,0,0,0,0,0,0,0,0,0,0,0,12
14,0,0,0,0,0,0,0,0,0,0,0,0,0,0,0,0,0,0,12
14,0,0,0,0,0,0,0,0,0,0,0,0,0,0,0,0,0,0,12
14,0,0,0,0,0,0,0,0,0,0,0,0,0,0,0,0,0,0,12
14,0,0,0,0,0,0,0,0,0,0,0,0,0,0,0,0,0,0,12
14,0,0,0,0,0,0,0,0,0,0,0,0,0,0,0,0,0,0,12
14,0,0,0,0,0,0,0,0,0,0,0,0,0,0,0,0,0,0,12
14,0,0,0,0,0,0,0,0,0,0,0,0,0,0,0,0,0,0,12
14,0,0,0,0,0,0,0,0,0,0,0,0,0,0,0,0,0,0,12
21,7,7,7,7,7,8,0,0,25,37,0,0,6,7,7,7,7,7,23
13,13,13,13,13,13,14,0,0,0,0,0,0,12,13,13,13,13,13,13
13,13,13,13,13,13,38,0,0,0,0,0,0,47,13,13,13,13,13,13
13,13,13,13,13,13,13,13,13,13,13,13,13,13,13,13,13,13,13,13
13,13,13,13,13,13,13,13,13,13,13,13,13,13,13,13,13,13,13,13
13,13,13,13,13,13,13,13,13,13,13,13,13,13,13,13,13,13,13,13
