1,1,1,1,1,1,1,1,1,1,1,1,1,1,1,1,1,1,1,1
1,1,1,1,1,1,7,7,1,1,1,1,1,1,1,1,1,1,1,1
1,1,1,1,1,1,3,5,1,1,1,1,1,1,1,1,1,1,1,1
1,1,15,1,1,1,1,1,1,1,1,1,1,1,1,1,1,1,1,1
1,1,15,1,1,1,1,1,1,1,1,1,1,1,1,1,1,1,1,1
1,1,1,1,1,1,1,1,1,1,1,1,1,7,10,1,1,1,1,1
1,1,1,1,1,1,1,1,1,1,1,1,1,9,14,1,1,1,1,1
1,1,1,1,1,1,1,1,8,2,1,1,1,1,1,1,1,1,1,1
1,1,1,1,1,1,1,1,3,4,1,1,1,1,1,1,1,1,1,1
1,1,1,1,1,1,1,1,1,1,1,1,1,1,1,1,1,1,1,1
