9,10,10,10,10,10,10,10,10,10,10,10,10,10,10,10,10,10,10,10,10,10,10,10,10,10,10,10,10,10,10,10,10,10,10,10,10,10,10,11
15,0,0,0,0,0,0,0,0,0,0,0,0,0,0,0,0,0,0,0,0,0,0,0,0,0,0,0,0,0,0,0,0,0,0,0,0,0,0,17
15,0,0,0,0,0,0,0,0,0,0,0,0,0,0,0,0,0,0,0,0,0,0,0,0,0,0,0,0,0,0,0,0,0,0,0,0,0,0,17
15,0,0,0,0,0,0,0,0,0,0,0,0,0,0,0,0,0,0,0,0,0,0,0,0,0,0,0,0,0,0,0,0,0,0,0,0,0,0,17
15,0,0,0,0,0,0,0,0,0,0,0,0,0,0,0,0,0,0,0,0,0,0,0,0,0,0,0,0,0,0,0,0,0,0,0,0,0,0,17
21,7,7,7,7,7,82,0,0,0,75,7,7,7,7,7,7,7,7,8,25,31,31,31,31,31,31,31,31,31,31,31,31,31,31,31,31,31,37,12
13,13,13,13,13,13,0,0,0,0,0,13,13,13,13,13,13,13,13,14,0,0,0,0,24,0,0,0,0,0,0,0,0,0,0,0,0,0,0,17
13,13,13,13,13,13,0,0,0,0,0,13,13,13,13,13,13,13,13,14,0,0,0,0,30,0,0,0,0,0,0,0,0,0,0,0,0,0,0,17
13,13,13,13,13,13,0,0,0,0,0,13,13,13,13,13,13,13,13,14,0,0,0,0,30,0,0,0,0,0,0,0,0,0,0,0,0,0,0,17
13,13,13,13,13,13,0,0,0,0,0,13,13,13,13,13,13,13,13,14,0,0,0,0,30,0,0,0,0,0,0,0,0,0,0,0,0,0,0,17
13,13,13,13,13,13,0,0,0,0,0,13,13,45,0,0,0,0,40,14,0,0,0,0,30,0,0,0,0,0,0,0,0,75,8,0,0,0,0,12
13,13,13,13,13,13,0,0,0,0,0,13,13,59,0,0,0,0,50,14,0,0,0,0,30,0,0,0,0,0,0,0,0,0,59,0,0,0,0,50
13,13,13,13,13,13,0,0,0,0,0,13,13,0,0,0,0,0,0,14,0,0,0,0,30,0,0,0,0,0,0,0,0,0,0,0,0,0,0,0
13,13,13,13,13,13,0,0,0,0,0,13,13,0,0,0,0,0,0,14,0,0,0,0,30,0,0,0,0,0,0,0,0,0,0,0,0,0,0,0
13,13,13,13,13,13,0,0,0,0,0,13,13,0,0,0,0,0,80,20,0,0,0,0,30,0,0,0,0,0,0,0,0,0,0,0,0,0,0,0
13,13,13,13,13,13,0,0,0,0,0,13,13,0,0,0,0,0,0,0,0,0,0,0,30,0,0,0,0,0,0,0,0,0,0,0,0,0,0,0
13,13,13,13,13,13,0,0,0,0,0,13,13,0,0,0,0,0,0,0,0,0,0,0,30,0,0,0,0,0,0,0,0,0,0,0,0,0,0,0
13,13,13,13,13,13,0,0,0,0,0,13,13,0,0,0,0,0,75,8,0,0,0,0,30,0,0,0,0,0,0,0,0,0,0,0,0,0,0,0
13,13,13,13,13,13,0,0,0,0,0,13,13,0,0,0,0,0,0,14,0,0,0,0,30,0,0,0,0,0,0,0,0,0,0,0,0,0,0,0
13,13,13,13,13,13,0,0,0,0,0,13,13,0,0,0,0,0,0,14,0,0,0,0,30,0,0,0,0,0,0,0,0,0,0,0,0,0,0,0
13,13,13,13,13,13,0,0,0,0,0,13,13,0,0,0,0,0,0,14,0,0,0,0,30,0,0,0,0,0,0,0,0,0,0,0,0,0,0,0
13,13,13,13,13,13,0,0,0,0,0,13,13,0,0,0,0,0,0,14,0,0,0,0,30,0,0,0,0,0,0,0,0,0,0,0,0,0,0,0
13,13,13,13,13,13,0,0,0,0,0,13,13,0,0,0,0,0,0,14,0,0,0,0,30,0,0,0,0,0,0,0,0,0,0,0,0,0,0,0
13,13,13,13,13,13,0,0,0,0,0,13,13,0,0,0,0,0,0,14,0,0,0,0,36,0,0,0,0,0,0,0,0,0,0,0,0,0,0,0
13,13,13,13,13,13,0,0,0,0,0,13,13,0,0,0,0,0,0,14,0,0,0,0,0,0,0,0,0,0,0,0,0,0,0,0,0,0,0,0
13,13,13,13,13,13,0,0,0,0,0,13,13,0,0,0,0,0,0,14,0,0,0,0,0,0,0,0,0,0,0,0,0,0,0,0,0,0,0,0
13,13,13,13,13,13,0,0,0,0,0,13,13,0,0,0,0,0,0,14,0,0,0,0,0,0,0,0,0,0,0,0,0,0,0,0,0,0,0,0
13,13,13,13,13,13,0,0,0,0,80,11,13,0,0,0,0,0,80,20,25,31,31,31,37,0,0,0,0,0,0,0,0,0,0,0,0,0,0,0
13,13,13,13,13,13,0,0,0,0,0,18,11,0,0,0,0,0,0,0,0,0,0,0,0,0,0,0,0,0,0,0,0,0,0,0,0,0,0,0
13,13,13,13,13,13,0,0,0,0,0,0,18,77,0,0,0,0,0,0,0,0,0,0,0,0,0,0,0,0,0,0,0,57,0,0,0,0,0,0
13,13,13,13,13,13,0,0,0,0,0,0,0,0,0,0,0,0,0,0,0,0,0,0,0,0,0,0,0,0,0,0,0,12,0,0,0,0,0,0
13,13,13,13,13,13,0,0,0,0,0,0,0,0,0,0,0,0,0,0,0,0,0,0,0,0,0,0,0,0,0,0,0,12,0,0,0,0,0,0
13,13,13,13,13,13,0,0,0,0,0,0,0,0,0,0,0,0,0,0,0,0,0,0,0,0,0,0,0,0,0,0,0,12,0,0,0,0,0,0
13,13,13,13,13,13,0,0,0,0,0,0,0,0,0,0,0,0,0,0,0,0,0,0,0,0,0,0,0,0,0,0,0,12,52,0,0,0,0,57
13,13,13,13,13,13,0,0,0,0,75,7,7,8,0,0,0,0,0,0,0,0,0,0,0,0,0,0,0,0,0,0,0,12,14,0,0,0,0,17
13,13,13,13,13,13,0,0,0,0,0,13,13,14,0,0,0,0,0,0,0,0,0,0,0,0,0,0,0,0,0,0,0,12,14,0,0,0,0,17
13,13,13,13,13,13,0,0,0,0,0,13,13,14,0,0,0,0,0,0,0,0,0,0,0,0,0,0,0,0,0,0,0,12,21,7,7,7,7,23
13,13,13,13,13,13,0,0,0,0,0,13,13,14,0,0,0,0,0,0,0,0,0,0,0,0,0,0,0,0,0,0,0,12,13,13,13,13,13,13
13,13,13,13,13,13,0,0,0,0,0,13,13,14,0,0,0,0,0,0,0,0,0,0,0,0,0,0,0,0,0,0,0,12,13,13,13,13,13,13
13,13,13,13,13,13,48,0,62,0,49,13,13,38,0,0,62,0,0,0,0,0,0,0,0,0,0,0,0,0,0,0,0,47,13,13,13,13,13,13
