1,1,1,1,1,1,1,1,1,1,1,1
1,1,1,1,1,1,1,1,1,1,1,1
1,1,1,1,1,1,1,2,7,1,1,1
1,1,1,1,1,1,3,4,1,1,1,1
1,1,1,1,1,1,1,1,1,1,1,1
1,1,1,1,1,1,1,1,1,1,1,1
1,1,1,1,1,1,1,1,1,2,1,1
1,1,1,1,1,1,1,1,1,6,1,1
1,8,8,10,1,1,1,1,1,1,1,1
1,15,11,12,1,1,1,1,1,1,1,1
1,1,1,1,7,1,1,1,1,1,1,1
1,1,1,1,1,1,1,1,1,1,1,1
