1,1,1,1,1,1,1,1,1,1
1,1,1,1,1,1,1,1,1,1
1,1,24,25,1,1,1,1,1,1
1,1,32,33,1,15,1,1,1,1
1,1,1,1,1,1,1,1,1,1
1,1,1,1,1,1,1,2,1,1
1,1,1,1,1,1,1,6,1,1
1,1,1,1,1,1,1,1,1,1
