1,1,1,1,1,1,1,1,1,1,1,1
1,1,1,1,1,1,1,1,1,1,1,1
1,1,10,1,1,1,1,1,1,1,1,1
1,1,14,1,1,1,1,1,1,3,5,1
1,1,1,1,1,1,1,1,1,1,2,1
1,1,1,1,1,1,1,1,1,1,6,1
1,1,1,1,1,1,1,1,1,1,2,1
1,1,1,1,15,15,9,1,1,1,6,1
1,1,1,1,1,1,1,1,1,1,2,1
1,1,1,1,1,1,1,1,1,3,4,1
1,1,1,1,7,1,1,1,1,1,1,1
1,1,1,1,1,1,1,1,1,1,1,1
