1,1,1,1,1,1,1,1,1,1,1,1,1,1,1,1,1,1,1,1
1,1,1,1,1,1,1,1,1,1,1,1,1,1,1,1,1,1,1,1
1,1,15,15,7,15,1,1,1,1,1,1,1,1,1,1,1,1,1,1
1,1,1,1,1,1,1,1,1,1,1,1,8,10,1,1,1,1,1,1
1,1,1,1,1,1,1,1,1,1,1,1,11,12,1,1,1,1,1,1
1,1,1,1,1,1,1,1,1,1,1,1,1,1,1,1,8,2,1,1
1,1,1,1,1,1,1,1,1,1,1,1,1,1,1,1,3,4,1,1
1,1,1,1,1,1,8,2,10,1,1,1,1,1,1,1,1,1,1,1
1,1,1,1,1,1,3,4,14,1,1,1,1,1,1,1,1,1,1,1
1,1,1,1,1,1,11,13,9,1,1,1,1,1,1,1,1,1,1,1
1,7,7,1,1,1,1,1,1,1,1,1,1,1,1,1,10,1,1,1
1,7,9,1,1,1,1,1,1,1,15,1,1,1,1,1,14,1,1,1
1,1,1,1,1,1,1,1,1,1,1,1,1,1,1,1,1,1,1,1
1,1,1,1,1,1,1,1,1,1,1,1,1,1,1,1,1,1,1,1
1,1,1,1,1,1,1,1,1,1,1,1,1,1,1,1,1,1,1,1
1,1,1,1,9,15,1,1,1,1,1,1,1,1,1,1,1,1,1,1
1,1,1,1,1,9,9,10,1,1,1,1,1,1,1,1,1,1,1,1
1,1,1,1,1,1,11,12,1,1,1,1,1,1,1,1,1,1,1,1
1,1,1,1,1,1,1,1,1,1,1,1,1,1,1,1,1,1,1,1
1,1,1,1,1,1,1,1,1,1,1,1,1,1,1,1,1,1,1,1
